6
S O O O O K
W O W I W O
W O O W W W
I W O O O O
O W O W D O
O O O O W W