6
S O O O O K
W O W W W O
W O O W W W
W W O O O O
W W O W D O
W O O O W W