20
W W W W O O O O O O B O W O O O O O I O
O O O W O O O O O O O O W O W D O O O O
O W O W W W W W O W O O W O W W W W W W
O W O O O O O W O W O I W O O O W O O O
O W W W W W O W G W O O W O W O W O W O
O O O O O W O W W W O O W O W W W O W O
O G I W O W O O O O O O W O O O O O W O
W W W W O W O W W W W W W W W W W W W O
O O O O O W O O O O O O O O O G W O O O
O W W W W W W W W W W W W W W W W O W W
O O O O O O O O O O O O O O O O O O O O
W W W W W W W W W W W W W W W W W W W O
B O O O O O O O O O O O O O O O O O O O
O O W W W W O W W W W W W O O O O O G O
O O W O O W I W O O O O W O B O G O O O
O O W O O W O W O O I O W O O O O O O O
O B W O O W O W O O O O W O O O O O O O
W W W O O W O W O O O O W W W W W O O O
O O O O O W I W O O O O O O O O O O O O
S W O W O O O O O O O O O O O O O K O O


Enemies: KernelEnemy PThreadEnemy ShellEnemy ||
Items: Coffee RedBullFourPack SnowDay FastFood RedBull ReverseCompiler Virus ||


This is the formatting that must be used!
