5
S O O O K
W O W W W
W O O W W
W W O O O
W W W W D
