100
W W W W W W W W W W W W W W W W W W W W W W W W W W W W W W W W W W W W W W W W W W W W W W W W W W W W W W W W W W W W W W W W W W W W W W W W W W W W W W W W W W W W W W W W W W W W W W W W W W W W
W W W W W W W W W O G W W W W W W W W W W I O W W W W W W W O O O O O W W W W W W W W W W W W W W W W W W W W W W W W W W W W W W W W W W W W W W W W W W W W W W W W W W W W W W W W W W W W W W W W W
W W W W W W W W W O O W W W W W W W W W W O O W W W W W W W O O W W O O O O W W W W W W W W W W W W W W W W W W W W W W W W W W W W W W W W W W W W W W W W W W W W W W W W W W W W W W W W W W W W W W
W W W W W W W W W O O W W W W W W W W W W O O W W W W W W W O O W W O W W O W W W W W W W W W W W W W W W W W W W O O O W W W W O O O O O W O O O O O W W W W W W W W W W W W W W W W W W W W W W W W W
W W W W O O O O W O O O O O O O O O O O O O O W W W W W W W O O W O O W W O W W W W W W W W W W W W W W W W W W W O I O W W W W O O I O O W O O I O O W W W W W W W W W W W W W O O O O O W W O O W W W
W W W W O W W W W O O W W W W W W W W W W O O W W W W W W W O O O O W O W O W W W W W W W W W W W O O O O O O O O O O O W W W W O O G O O W O O G O O W W W W W W W W W W W W O O W W W O W W O O W W W
W W W W O W W W W O O W W W W W W W W W W O O O O O O O O O O O O W W O O O O O O O O W W W W W W O W O O W W W W W W W W W W W O O B O O W O O O O O O O O O O W W W W W W W O O W W W O W W O O W W W
W W W W O W W W W O O W W W W W W W W W W O O W W W W W W W W W W W W O W O W W W O I W W W W W W O W O O O O O O O O O O O O O O O O O O W W W W W W O O W O O W W W W W W W O O W W W O O O O O W W W
W W W O O W W W W O O W W W O O O O O O O O W W W W W W W O O O O W W O O O W W W O O O O O O O W O W O O W W W W W W W W W W W W W W W W W W W W W W O O G O O W W W W W W W O O W W W O W W W O W W W
W W W O O W W W W O O W W W O W W W W W W W W W W W W W W O O O O W W W W W W W W O O W W W W O W O W O O O O O O O O O O O O O O O O O O O O O W W W O O W O O W W W W W W W O O W W W O W W W O W W W
W W W O O W W W W W W W W W O W W W W W W W O O O O W W W O W W W W W W W W O O O O O W W W W O O O W O O W W W W W W W W W W W W W W O O O O O W W W W W W W O O O O O O O O O O W W W O W W W D W W W
W W W O O W O O W W W W W W O W W W W W W W O O O O O O O O W W W O O O O O O O W W W W W W W W W W W O O O O O O O W W W W W W W W W O O O O O W W W W W W W O W W W W W W W O O W W W O W W W W W W W
W W W O O W O O W W W W W W O W W W O O O O O O O O O O O W W W W O O O W W O O W W W W W W W W W W W W W W W W W O O O O O O W W W W O O O O O W W W W W W W O W W W W W W W O O W I O O W W W W W W W
W W W O O W O O W W W W W W O W W W O W W W O O O O W W W W W W W O O O W W W W W W W W W W W W W W W W W W W W W W W W O O O W W W W O O O O O W W W W O O O O W W W W W W W O O W W W O W W W W W W W
W W W O O W W O O O O O O O O W W W O W W W W W W W W W W W W W W O O O W W W W W W W W W W W W W W W W W W W W W W O W W W O W W W W W W W W W W W W W O W W W W W W W W W W O O W W W O W W W W W W W
W W W O O O O O W W W W W W O W W W O W W W W W W W W W W W W W W W W W W W W W W W W W W W W W W W W W W W W W W W O O O O O W W W W W W W W W W W W W O W W W W W W O W W W O O W W W O W W O O O W W
W W W W O O O O W W W W W W O O O O O W W W O O O O O O O S W O O O O O O O O O O W W W W W W W W W O O O O O W W W O O O O O W W O O O O O O O O O W W O O O O O W W O W W W O O W W W O W W O O O W W
W W W W O O O O W W W W W W O O O O O W W W O W W W W W W W W O W W W W W W W W O W W W W W W W W W O W W W O W W W W W W W O W W O W W W W W W W O W W O O O O O W W O W W W W W W W W O W W O O O W W
W W W W O O O O W W W W W W O O O O O W W W O W O O O O O O W O W O O O O O O W O W O W W W W W O W O W O W O W W W W O O W W W W O W O O O O W W O W W O O I O O W W O W W W W W W W W O W W O G O W W
W W W W W O O W W W W W W W O O O O O W W W O W O W W W W W W O W O W W W W W W O W O O W W W W O W O W O W O W W W O W W O W W W O W O W W O W W O W W O O I O O W W O W W W W W W W W O W W O O O W W
W W W W W O O W W W W W W W O O O O O W W W O W O W W W W W W O W O W W W W W W O W O W O W W W O W O W O W O W W O W W W W O W W O W O W W O W W O W W O O O O O W W O W W W W W W W W O W W O O O W W
W W W W W O O W W W W W W W W W W O W W W W O W O O O O O O W O W O W W W W W W O W O W W O W W O W O W O W O W O W W W W W W O W O W O O O O W W O W W W W O O O O O O W W W W W W W W O O O O O O W W
W W W W W O O O W W W W W W W W W O O O W W O W W W W W W O W O W O O O W W W W O W O W W W O W O W O W O W O W O W W W W W W O W O W O O W W W W O W W W W O I O W W O W W W W W W W W W W W W O W W W
W W W W W W W O W W W W W W W W W W W O W W O W W W W W W O W O W O W W W W W W O W O W W W W O O W O W O W O W W O W W W W O W W O W O W O W W W O W W W W O O O W W O W W W W W W W W W W W W O W W W
W W W W W W W O W W W W W W W W W W W O W W O W W W W W W O W O W O W W W W W W O W O W W W W W O W O W O W O W W W O W W O W W W O W O W W O W W O W W W W W W W W W O O O O O O O W W W W W W O W W W
W W W W W W W O W W W W W W W W W W W O W W O W O O O O O O W O W O O O O O O W O W O W W W W W O W O W O W O W W W W O O W W W W O W O W W W O W O O O O O O O O O O O W W W W W O W W W W W W O W W W
W W W W W W W O I W O O O O O O O O O O W W O W W W W W W W W O W W W W W W W W O W W W W W W W W W O W W W O W W W W W W W W W W O W W W W W W W O W W W W W W W W W W W W W W W O W W W W W W I W W W
W W W W W W W W W W O W W W W W W W W W W W O O O O O O O O O O W W W W W W W W O O O O O O O O O O O W W W O O O O O O O O O O O O W W W W W W W O W W W W W W W W W W W W W W W O W W W W W W W W W W
W W W W W W W W W W O W W O O O O O O O W W W W W W W W W W W W W W W W W W W W W W W W W W W W W W W W W W W W W W W W W W W W W W W W W W W W W O W W W W W W W W W W W W W W W O W W W W W W W W W W
W W W W W W W W W W O O W O W W O O O O W W W W W W W W W W W O O W W W W W W W W W W W W W W W W W W W W W W W W W W W W W W W W W W W W W W W W O W W W W W W W W W W W W W W W O W W W W W W W W W W
W W W W W W W W W W W O W O O O O W W W W O O O O O I W W W W O O W W O O O O W W W W W W W W W W W W W W W W W W W W W W W W W W W W W W W W W O O W W W W W W W W W W W W W W W O W W W W W W W W W W
W W W W W W W W W W W O W W W W O O O O O O W O O O O W W W W O O W W O O O O W W W W W W W W I O O O O O O O W W W W W W W W W W W W W W W W W O W W W W W W W W W W W W W W W W O O O O O O O O W W W
W W W W W W W W W W W O O W W W O W W W W O W W W O W W W W W O O O O O O I O W W W W W W W W W O O O O O W O W W W W W W W W W W W W W W W W W O W W W W W W W W W W W W W W W W O W W W W W W O W W W
W W W W W W W W W W W W O W W W O W W W W O W W W O W O O W W O O W W O O O O W W W W O O O O W O O O O O W O W W W W W W W W W W W W W W W W W O W W W W W W W W W W W W W W W W O W W W W W O O W W W
W W W W W W W W W W W O O W O O O W W W W O W W W O W O O W W O O W W O W W W W W W W O W W O W W W W W O W O W W W W W W W W W W W W W W W W W O W W W W W W W W W W W W W W W W O W W W W W O O W W W
W W W W W W W W W W W O W W O O W W W W O O O O W O W O O W W W W W W O W W W W W W W O W W O O O W W W W W O W W W W W W W W W W W W W W W W W O W W W W W W W W W W O O W W W O O W W W W W O G W W W
W W W W W W W W W W W O W W O O W W O O O O O O W O W O O O O O O O O O O O O O O O O O W W W W O W W W W W O W W W W W W W W W W W W W W W W W O W W W W W W W W W W O O W W W O W W W W W W O O W W W
W W W W W W W W W W O O W W O O W W W W O O O O W O O O O W W W W W W O W W W W W W O O W W W W O W W W W W O O O O O O O O O O O O O O O O O O O W I O O O O O O W W O O W W W O W W W O O O O O W W W
W W W W W W W W W W O W W W W W W W W W W W W W W W W O W W W W W W W O W W W W W W O O W W W O O W W W W W O W W W W W W O W W W W W W W W W W W W W W W W O W O W W O O W W W O W W W O W W G O W W W
W W W W W W W W W W O O O O O O O O O O O O O O O W W O W W W W W W W O W W W W W W O O W W O O W W W W W W O W W W W W W O W W W W W W W W W W W W W W W W O W O W W B O O O O O W W W O W W W W W W W
W W W W O O O O O W W W W W W W W W W W W W W O O O O O W W O O O O O O O W W W W W O O W W O O O W W W W W O W W W W W W O O W W W W W W W W W W W W W W W O W O W W O O O O O O W W W O W W I W W W W
W W W W O W W W O W W W W W W W W W W W W W W O O O O W W W O W W W O O O W W W W W O O W W O G O W W W W W O W W W W W W O O W W W W W W W W W W W W W W W O W O W W I O W W O O W W W O O O O W W W W
W W W W O W W W O W W W W W W W W W W W W W W O O O O W W O O W W W O O O W W W W W W W W W O O O W W W W W O W W W W W W O O W W W W W W W W W W W O O O O O W O W W O O O W O O W W W W W W W W W W W
W W W W O W W O O O O O O O O O O W W W W W W O O O O W W O W W W W O O O W W W W W W W W W O O O O W I W W O W W W W W W O O O O O O O O O W W W W O O O O O W O W W I O O O O O W W W W G W W W W W W
W W W W O W W O W W W W W W W W O W W W W W W O O O O W I O W O O O O O O W W W W W W W W W W W W O W O W W O W W W W W W W W W W O O O O O W W W W O O O O O W O W W W W W W W W W W W W O W W W W W W
W W W W O W W O W W W W W W W W O W W W W W W O O O O W W W W O W W W W W W W W W W W W W W W W W O W O W W O W W W W W W W W W W O O O O O W W W W O O O O O W O W W W W W W W W W W W W O W W W W W W
W W W W O W W O W W W W W W W W O W W W W W W O O O O W W W W O W W W W W W W W W W W W W W W W W O O O W W O W W W W W W W W W W O O O O O O O O O O O O O O W O W W W W W W W W W W W W O W W W W W W
W W W W O W W O W W W W W W W W O W W W W W W O O O O W W W W O W W W W W W O O O O O O O O O W W W W W W W O W W W W W W W W W W W W W W W W W W W W W W W W W O W W W W W W W W W W W W O W W W W W W
W W W W O W W O W W W W W W W W O W W W W W W O O O W W W W W O O O O W W W O O O O O O O O O W W W W W W W O O O O O O O O O O O O O O O O O O O O O O O O W W O O O O O O O O O O O O O O W W W W W W
W W W W O W W O W W W W W W W W O W W W W W W W W O W W W W W O W O O W W W O O O O O O O O O O O O O O O O O O O O O O O O O O O O O O O O O O O O O O O O W W O W W W W W W W W W W W W W W W W W W W
W W W W O W W O W W W W W W W W O W W W W W W W W O W W W W W O W O O W W W O O O O I O O O O W W W W W W W W W W W W W W W W W W W W W W W W W W W W W W W W W O W W W W W W W W W W W W W W W W W W W
W W W W O W W O O O O O O O O O O W W W W W W W W O W W W W W O O O O W W W O O O O O O O O O W W W W W W W W W W W W W W W W W W W W W W W W W W W W W W W W W I W W W W W W W W W W W W W W W W W W W
W W W W O W W O W W W W W W W O W W W W W W W W W O O W W W W W W W W W W W O O O O O O O O O W W W W W W W W W W W W W W W W W W W W W W W W W W W W W W W W W W W W O O O O O O O O O O O O O W W W W
W W W W O W W O W W W W W W W O W W W W W W W W W O O O O O O O O O O O O O O O G O O O O O W W W W W W W W W W W W W W W W W W W W W W W W W O O O O O O W W W W W W K W W W W W W W W W W W O W W W W
W W W W O W W O W W W W W W W O W W W W W W W W W O W W W W W W W W W W O O O O O O O O O W W W W W W W W W W W W W W W W W W W W W W W W W W O W W W W O W W W W W W O W W W W W W W W W W W O W W W W
W W W W O W W O W W W W W W W O W W W W W W W W W O W W W W W W W W W O O O O O O O O O W W W W W W W W W W W W W W W W W W W W W W W W W W W O W W W W O W W W W W W O W W W W W W W W W W W O W W W W
W W W W O O W O W W W W W W W O W W W W W W W W W O W W W W W W W W O O O O O O O O O W W W W W W W W W W W W W W W W W W W W W W W W W W W W O W W W W O W W W W W W O W W W W W W W W W W W O W W W W
W W W W W O W O W W W W W W W O W W W W W W W W W O W W W W W W W O O O O O O O O O O O O O O O O O O W W W W W W W W W W W W W W W W W W W W O W W W W O W W W W W W O W W W W W W W W W W W O W W W W
W W W W W O W O O O O O O O O O W W W W W W W W W O W W W W W W O O O O O I O O O W W W W W W W W W W W W W W W W W W W W W W W W W W W W W W O W W W W O W W W W W W O W W W W W W W W W W O O W W W W
W W W W W O W W W W W W W W W O W W W W W W W W W O W W W W W W W O O O O O O O O O W W W W W W W W W W W W W W W W W W W W W W W W W W W W W O W W W W O W W W W W W O W O O W W W W W W W O O W W W W
W W W W W O O O O O O O O O W O W W W W W W W W W O W W W W W W W W O O O O O O O O O W W W W W W W W W W W W O O W W W W W W O W W W W W W W O W W W W O W W W W W W O W O O W W W W W W W O O W W W W
W W W W W W W W W W W W W O W O W W W W W W W W W O W W W W W W W W W W O O O O O O O O O W W W W W W W W W W O O W W W W W W O W W W W W W W O W W W W O W W W W W W O W O O W W W W W W W O O W W W W
W W W W W W W W W W W W W O W O O O O W W W W W W O W W W W W W W W W W W W O O O O O O O O O W W W W W W W W O O W W W W W W O W W W W W W W O W W W W O W W W W W W O W O O W W W W W W W O O W W W W
W W W W W W W W W W W W W O W O O O O W W W W W W O W W W W W W W W W W W W W W W W W W O W W W W W W W W W W O O W W W W W W O W W W W W W W O W W W W O W W W W W W O W O O W W W W W W W O O W W W W
W W W W W W W W W W W W W I W O O O O W W W W W W O W W W W W W W W W W W W W W W W W W O W W W W W W W W O O O O W W W W W W O W W W O O O O O W W W W O W W W W W W O W O O W W W W W W W O O W W W W
W W W W W W W W W W W W W I W O O O O W W W W W W O W W W W W W W W W W W W W W W W W W O W W W W W W W W O W O O W W W W W W O W W W O O O O W W W W W O W W W W W W O W O O W W W W W W W O O W W W W
W W W W W W W W W W W W W I W O B O O W W W W W W O O O O O O O O O O W W W W W W W W W O W W W W W W W W O W O O W W W W W W O O O O O O O O W W W W W O W W W W W W O O O O W W W W W W W O O W W W W
W W W W W W W W O I W W W I W O O O O O O O O O O O O O O O B O O O O W W W W W W W W W O O O O O O O O O O W O O W W W W W W W W W W W W W O W W W W W O W W W W W W W O O O W W W W W W W O O W W W W
W W W W W W W W O O W W W O W O O O O W W W O W W O O O O O O O O O O W W W W W W W W W O W W W W W W W W W W O O W W W W W O O O O O O O O O W W W W W O W W W W W W W O O O W W W W W W W O O W W W W
W W W W W W W W O O W W W O W O O O O W W W O W W O W W W W W W W W W W W W W W W W W W O W W W W W W W W W W O O W W W W W O W W W W W W W W W W W W W O W W W W W W W O O O W W W W W W W O O W W W W
W W W W W W W W O O W W W O W O O O O W W W O W W O W W W W W W W W W W W W W W W W W W O W W W W W W W W W W O O W W W W W O W W W W W W W W W W W W W O W W W W W W W W W O W W W W W W W O O W W W W
W W W W W G O O O O W W W O W O O O O W W I O W W O W W W W W W W W W W W W W W W W W W O W W W W W W W W W W W W W W W W W O W W O O W W W W W W W W W O O O O O O O O O O O W W W W W W W O O W W W W
W W W W W W W W W O O O O O W O O O O W W W W W W O W W W W W W W W W W W W W W W W W W O O O O O O O O O O O W W W W W W W O W W O O W W W W W W W W W W W W W W O W W W W W W W W W W W W O O W W W W
W W W W W W W W W W W W W W W W W W W W W W W W W O W W W W W W W W W W W W W W W W W W W W W W W W W W W W O W W W W W W W O W W O O O W W O O W W W W W W W W W O W W W W W W W W W W W W O I W W W W
W W W W W W W W W W W W W W W W W W W W W W W W W O O O O O O O O O O W W W W W W W W W W W W W W W W W W W O W W W W W W W O W W O O O W W O O W W W W W W W W W O W W W W W W W W W W W W W W W W W W
W W W W W W W W W W W W W W W W O O W W W W W W W O W W W W W W O O O W W W W W W W W W W W W W W W W W W W O W W W W W W W O W W O O O W W O O W W W W W W W W W O W W W W W W W W W W W W W W W W W W
W W W W W W W W W W W W W W W W O O W W B O W W W O W W W W W W O O O W W W W W W W W W W W W W W W W W W W O W W W W W W W O W W O O O W W O O W W W W W W W W W O W W W W W W W W W W W W W W W W W W
W W W W W W W W W W W W W W W W O O W W O O W W W O W W W W W W O O O W W W W W W W W W W W W W W W W W W W O W W W W W W W O W W O O O W W O O W W W W W W W W W O W W W W W W W W W W W W W W W W W W
W W W W W W O O I W W W W W W W O O W W O O W W O O O W W W W W W W W W W W W W W W O O O O O O O O O O O O O O O O O O O O O W W W O O W W O O W W W W W W W W W O O O O W W W W W W W W W W W W W W W
W W W W W W O O O W W W W W O O O W W O O O W O O W O O W W W W W W W W W W W W W W W W W W W W W W W W W W W W W W W W W W W W W W O W W W O O O O O O O O O O O O O O O W W W W W W W W W W W W W W W
W W W W W W O O O W W W W W O W W W W O W W W O O W O O W W W W W W W W W W W W W W W W W W W W W W W W W W W W W W W W W W W W W W O W W W O W W W W W O O O O O O O O O O W W W W W W W W W W W W W W
W W W W W W O O O W W W W W O W W W W O W W W O O W O O W W W W W W W W W W W W W W W W W W W W W W W W W W W W W W W W W W O O O O O W W W O W W W W W W W W W W W W W W O O W W W W W W W W W W W W W
W W W W W W O W W W O O O O O O O W W O W W W O O W O O W W W W W W W W W W W W W W W O O O O O O O W W W W W W W W W W W W O O O O O O W W O W W W W W W W W W W W W W W O O O W W W W W W W W W W W W
W W W W W W O W W W O O O I O O O W W O W W W O O W O O W W W W W W W W W W W W W W W O W W W W O O W W W W W W W W W W W W O O O O O O W O O W W W W W W W W W W W W W W O O O O O W W W W W W W W W W
W W W O O O O W W W O O O O O O O W W O W W W O O W O O W W W W W W W W W W W W W W W O W W W W O O W W W W W W W W W W W W O O O O O O W O O W W W W W W W W W W W W W W O O O O O O O O O W W W W W W
W W W O O O O W W W W W O O O O O W W O O O O O O W O O W W W W W W W W W W W W W W W O W W W W O O W W W W W W W W W W W W W W W W W O W O O W W W W W W O O W W W W W W O O O O O O O O O W W W W W W
W W W O O O O W W W O W O O W W O W W W W W W O O W O O W W W W W W W W W W O O O O O O W W W W O O W W W W W W W W W W W W W W W W W O W O O W W W W W O O O O W W W W W W W W W W W W W O W W W W W W
W W W O G O O O O O O O O O O W O W W W W W W O O W O B W W W W W W W W W W O W W O O O W W W O O O O O W W W W W W W W W O O O O W W O W O O W W W W O O W W O O W W W W W W W W W W W W O W W W W W W
W W W O O O O W W W O O O O O O O W W W W W W O O W O O W W W W W W W W W W O W W O O W W W W O O O O O W W W W W W W W W O O O O W W O W O O W W W O O W W W W O O W W W W W W W W W W W O W W W W W W
W W W O O O O W W W W W O W W W W W W W W W W O O W O O W W W W W W W W W W O W W O O W W W W W W W W W W W W W W W W W W O I O O W W O O O O W W O O W W W W W W O O W W W W W W W W W O O W W W W W W
W W W W W W W W W W W W O W W W W W W W W W O O O W W O O O W W W W W W W W O W W O O W W W W W W W W W W W W W W W W W W O O O O W W W W W W W W O O W W O W W W W O O W W W W W W W W O O W W W W W W
W W W W K W W W W W W W O W W W W W W W W O O O W W W W O O O W W W W W W W O W W O O O O O W W W W W W W W W W W W W O O O O O O O O O O O O O O O O W W O W W W W O O W W W W W W W W O O W W W W W W
W W W O O O W W W W W W O W W W W W W W O O O W W W W W W O O O W W W W W W O W W W W W W O W W W W W W W W W W W W W O W W O O O W W W W W W W W O O W W O W W W W O G O O W W W W W O O O W W W W W W
W W O O O O W W W W W W O W W W W W W O O O W W W W W W W W O O O W W W W W O W W W W W W O O O O O O W W W W W W W W O W W O O O W W W W W W W W O O W W W W W W W O O O O W W W W O O O O W W W W W W
W W O O W W W W W W W W O W W W W W O O O W W W W W W W W W W O O O W W W W O W W W W W W W W W W W O W W W W W W W W O W W O O I W W W W W W W W O O W W W W W W W O O O W W W W O O O O O W W W W W W
W W W O W W W W W W W W O W W W W O O O W W W W W W W W W W W W O O O W W W O W W W W W W W W W W W O W W W W W W W W O W W O O O W W W W W W W W O O W W W W W W W O O W W W W O O O I O O W W W W W W
W W O O O O O O O O O O O O O O O O O W W W W W W W W W W W W W W O O O W W O W W W W W W W W W W W O O O O O O O O O O W W W W W W W W W W W W W W O O O O O O O O O O W W W O O O O I O O W W W W W W
W W O O O W W W W W W W W W W W W W W W W W W W W W W W W W W W W W O O O O O W W W W W W W W W W W W W W W W W W W W W W W W W W W W W W W W W W W W W W W W W W W O W W W W O W W W W W W W W W W W W
W W W W O W W W W W W W W W W W W W W W W W W W W W W W W W W W W W W W W W W W W W W W W W W W W W W W W W W W W W W W W W W W W W W W W W W W W W W W W W W W W W W W W W W W W W W W W W W W W W W W
W W W W W W W W W W W W W W W W W W W W W W W W W W W W W W W W W W W W W W W W W W W W W W W W W W W W W W W W W W W W W W W W W W W W W W W W W W W W W W W W W W W W W W W W W W W W W W W W W W W W

Enemies: AgileEnemy SeniorItisEnemy SRSEnemy ||
Items: Coffee RedBullFourPack SnowDay FastFood RedBull ReverseCompiler Virus ||


This is the formatting that must be used!
