40
W W W W W W W W W W W W W W W W W W W W W W W W W W W W W W W W W W W W W W W W
W W W W W W W W W W W W W W W W W O O K W W W W W W W W W W W W W W W W W W W W
W W W W W W W W W W W W W W W W W O W W W W W W W W W W W W W W W W W W W W W W
W W W O O O O O O O O O O O O O O O O O O O O O O O O O O O O O O O O O O W W W
W W W O O O O O O O O O O O O O O O O O W W O O O O O O O O O O O O O O O W W W
W W W O O O O O O O O O O O O O O O O O W W O O O O O O O O O O O O O O O W W W
W W W O O O O O O O O O O O O O O O W W W W W W O O O O O O O O O O O O O W W W
W W W O O O O O O O O O O O O O O O W W W W W W O O O O O O O O O O O O O W W W
W W W O O O O O O O O O O O O O O O O O O O O O O O O O O O O O O O O O O W W W
W W W W W W W W W W W W W W W W W W W W W W W W W W W W W W W W W W O W W W W W
W W W O O O O O O O O O O O O O O O O O W W O O O O O O O O O O O O O O O W W W
W W W O O O O O O O O O O O O O O O O O W W O O O O O O O O O O O O O O O W W W
W W W O O O O O O O O I O O O O O O W W W W W W O O O O I O O O O O O O O W W W
W W W O O O O O O O O O O O O O O O W W W W W W O O O O O O O O O O O O O W W W
W W W O O O O O O O O O O O O O O O O O O O O O O O O O O O O O O O O O O W W W
W W W W O W W W W W W W W W W W W W W W W W W W W W W W W W W W W W W W W W W W
W W W O O O O O O O O O O O O O O O O O O O O O O O O O O O O O O O O O O W W W
W W W O O O O O O O O O O O O O O O O O O O O O O O O O O O O O O O O O O W W W
W W W O O O O O O O O O O O O O O O O O W W O O O O O O O O O O O O O O O W W W
W W W O O O O O O O O O O O O O O O O S W W O O O O O O I O O O O O O O O W W W
W W W O O O O O O O O O O O I O O O W W W W W W O O O O O O O O O O O O O W W W
W W W O O O O O O O O O O O O O O O W W W W W W O O O O O O O O O O O O O W W W
W W W W W W W W W W W W W W W W W W W W W W W W W W W W W W W W O W W W W W W W
W W W O O O O O O O O O O O O O O O O O O O O O O O O O O O O O O O O O O W W W
W W W O O O O O O O O O O O O O O O O O O O O O O O O O O O O O O O O O O W W W
W W W W W W W W W W W W W W O W W W W W W W W W W W W W W W W W W W W W W W W W
W W W O O O O O O O O O O O O O O O O O O O O O O O O O O O O O O O O O O W W W
W W W O O O O O O O O O O O O O O O O O W W O O O O O O O O O O O O O O O W W W
W W W O O O O O O O O O O O O O O O O O W W O O O O O O O O O O O O O O O W W W
W W W O O O O O O O O O O O O O O O W W W W W W O O B O O O O O O O O O O W W W
W W W O O O O O O O O O O O O O O O W W W W W W O O O O O O O O O O O O O W W W
W D W O O O O O O O O O O O O O O O O O O O O O O O O O O O O O O O O O O W W W
W O W O O O O O O O O O O O O O O O O O O O O O O O O O O O O O O O O O O W W W
W O W W W W W W W W W W W W W W W W W W W O W W W W W W W W W W W W W W W W W W
W O W O O O O O B O O O O O O O O O O O O O O O O O O O O O O O O O O O O W W W
W O O O O O O O O O O O O O O O O O O O O O O O O O O O O O O O O O O O O W W W
W W W W W W W W W W W W W W W W W W W W W W W W W W W W W W W W W W W W W W W W
W W W W W W W W W W W W W W W W W W W W W W W W W W W W W W W W W W W W W W W W
W W W W W W W W W W W W W W W W W W W W W W W W W W W W W W W W W W W W W W W W
W W W W W W W W W W W W W W W W W W W W W W W W W W W W W W W W W W W W W W W W




Enemies: InheritanceEnemy LinkedListEnemy RecursionEnemy ||
Items: Coffee RedBullFourPack SnowDay FastFood RedBull ReverseCompiler Virus ||


This is the formatting that must be used!
