12
O O O O O O O O O O O D
O O O O O K O O O O O O
W W W W W O W W W W W W
O O O O W O W O O O O O
O O O O W O W O O O O O
O O O O W O W O O O O O
O O O O W O W O O O O O
O O O O W O W O O O O O
O O O O W O W O O O O O
O O O O W O W O O O O O
O O O O W O W O O O O O
O O O O W S W O O O O O

Enemies:  ||
Items: Coffee RedBullFourPack SnowDay FastFood RedBull ReverseCompiler Virus ||


This is the formatting that must be used!
