40
W W W W W W W W W W W W W W W W W W W W W W W W W W W W W W W W W W W W W W W W
W O O O O O O O O O O O O O O O O O O O O O O O O O O O O O O O O O O O O O O W
W O O O O O O O O O O O O O O O O O O O O O O O O O O O O O O O O O O O O O O W
W O O O O O O O O O O O O O O O O O O O O O O O O O O O O O O O O O O O O O O W
W O O O O O O O O O O O O O O O O O O O O O O O O O O O O O O O O O O O O O O W
W O O O O O O O O O O O O O O O O O O O O O O O O O O O O O O O O O O O O O O W
W W W W W W W W W W W W W W W W W W W W W W W W W W W W W W W W W W W W W W W W
W W W W W W W W W W W W W W W W W W W W W W W W W W W W W W W W W W W W W W W W
W W W W W W W W W W W W W W W W W W W W W W W W W W W W W W W W W W W W W W W W
W W W W W W W W W W W W W W W W W W W W W W W W W W W W W W W W W W W W W W W W
W W W W W W W W W W W W W W W W W W W W W W W W W W I I W W W W W W W W W W W W
W O O O O W W W W W W W W W W W W W W W W W W W W W W W W W I W W W W W W W W W
W O O O O W W W W W W I I I W W W I I I W W W I W I W W D W I W W W W W W W W W
W O O O O W W W W W W W W W W W W W W W W W W W W W W W O W W W W W W W W W W W
W O O O O W W W W W I W O O O O O O O O O O O O O O O W O W W W W W W W W W W W
W O O O O W W W W W I W O W W W W W W W W W W W W W O W O W W W W W W W W W W W
W O O O O W W W W W I W O W O O O O O O O O O O O O O W O W I I I I I I I I I W
W O O O O W W W W W W W O W O W W W W W W W W W W W W W K W W W W W W W W W W W
W O O O O W W W W W W W O W O W O O O O O O O O O O O O O O O O O O O O O O O W
W O O O O W W W W W W W O W O W O W W W W W W W W W W W W W W W W W W W W W O W
W O O O O W W W W W W W O W O W O W S W I I I W O O O W O O O W O O O W O O O W
W O O O O W W W I W W W O W O W O W O W I W I W O W O W O W O W O W O W O W O W
W O O O O W W W I W W W O W O W O W O W I W I W O W O W O W O W O W O W O W O W
W O O O O W W W W W I W O W O W O W O W I W I W O W O W O W O W O W O W O W O W
W O O O O W W W W W I W O W O W O W O W W W W W O W O W O W O W O W O W O W O W
W O O O O W W W I W I W O W O W O W O W O O O W O W O W O W O W O W O W O W O W
W O O O O W W W I W W W O W O W O W O W O W O W O W O W O W O W O W O W O W O W
W O O O O W W W I W I W O W O W O W O W O W O W O W O W O W O W O W O W O W O W
W O O O O W W W I W I W O W O W O W O W O W O W O W O W O W O W O W O W O W O W
W O O O O W W W W W I W O W O W O W O W O W O W O W O W O W O W O W O W O W O W
W O O O O W W W I W I W O W O W O W O W O W O W O W O W O W O W O W O W O W O W
W O O O O W W W I W W W O W O W O W O W O W O W O W O W O W O W O W O W O W O W
W O O O O W W W W W W W O W O W O W O W O W O W O W O W O W O W O W O W O W O W
W O O O O W W W W W W W O W O W O W O W O W O W O W O W O W O W O W O W O W O W
W O O O O W W W I W I W O W O W O W O W O W O W O W O W O W O W O W O W O W O W
W O O O O W W W W W I W O W O W O W O W O W O W O W O W O W O W O W O W O W O W
W O O O O W W W W W I W O W O W O W O W O W O W O W O W O W O W O W O W O W O W
W O O O O W W W W W W W O W O W O W O W O W O W O W O W O W O W O W O W O W O W
W O O O O W W W W W W W O W O O O W O O O W O O O W O O O W O O O W O O O W I W
W W W W W W W W W W W W W W W W W W W W W W W W W W W W W W W W W W W W W W W W

Enemies:  ||
Items: Coffee RedBullFourPack SnowDay FastFood RedBull ReverseCompiler Virus ||


This is the formatting that must be used!
