40
W W W W W W W W W W W W W W W W W W W W W W W W W W W W W W W W W W W W W W W W
W W W W W W W W W W W W W W W W W W W W W W W W W W O O O W W W W W W W W W W W
W W W W W W W W W W W W W W W W O O O O O O O O O O O I O W W W W W W W W W W W
W W W W W W W W W W W W W W W W O W W W W W W W W W O O O W W W W W W W W W W W
W W W W W W W W W W W W W W W W O W W W W W W W W W W W W W W W W W W W W W W W
W W W W W O I O O O O O O O O O O O O O O O O O O O O O O O I O O O O W W W W W
W W W W W O O O O O O O O O O O O O O I O O K O O G O O O O O O O O O W W W W W
W W W W W W W W W W W W W O W W W W W W W W W W W W W W W W W W W W W W W W W W
W W W W W I O O O O O O O O O O O O O O O O O O O O O O O O O O O O O W W W W W
W W W W W W W W W W O O O O W W W W W O W W W W W O O O W W W W W O O W W W W W
W W W W W O O O O O O O O W W O O O W O W O O O W W O O O O O O O O O W W W W W
W W W W W O O O O W W W W W O O O O W O W O O O O W W W W W W O O O O W W W W W
W W W W W O O O O O O O O O O O O O W O W O O O O O O O O O O O O O O W W W W W
W W W W W O I O O O O O O O O O O O W I W O W W W W W W W W W W W O O W W W W W
W W W W W O O O W W W W W O O O O O W O W O W O O W O O O W O O W W O W W W W W
W W W W W O O O O O O O O O O G O O W O W O W I O O O W O O O O W O O W W W W W
W W W W W O O O O O W W W W W O O O W O W O W W W W W W W O W W W O W W W W W W
W W W W W O O O O O O O O O O O O O W O W O O O O O O O W O O O W O O W W W W W
W W W W W O O O O O O O O O O O W W W O W W W O O W I O W W W O W W O W W W W W
W W W W W W W W W W W W W W W W W O O O O O W W W W W W W O O O W O O W W W W W
W W W W W O O O O O O O O I O O O O O S O O O O O O O I O O W W W O W W W W W W
W W W W W O O O O O W W W W W W W O O O O O W W W W W W W O O O W O O W W W W W
W W W W W O O W W O O O W W W W W O O O O O W W W W W W W O O O W W O W W W W W
W W W W W W O O W O O O W W W W W W W O W W W W W W W W W O O O W O O W W W W W
W W W W W W W O O O O O W W W W W W W O W W W W W W W W O O I O W O W W W W W W
W W I W W W W W W W O O W W W W W W W O W W W W W W W W O O O O W O O W W W W W
W W O W W G O O O W O O W W W W W W W O W W W W W W W W O W O O W W O W W W W W
W W O W W O O W O O O O W W W W W W W I W W W W W W W W O W W O W O O W W W W W
W W O W W O W W W W W W W W W W W W W O W W W W W W W W O O O O W O W W W W W W
W W O W W O W W O O O O W W W W W W W O W W W W W W W W W W W W W O O W W W W W
W W O O O O O O O W O O W W W W W W W O W W W W W W W W W W W O O O O W W W W W
W W W W W W W W W W O O W W W O W O O O O O W O O W W W W W W O W W W W W W W W
W W W W W O O O O O O O W W W O O O O O W O O O W W W W W W W O W G O W W W W W
W W W W W G O O O O O O W W W O W W W O W W W O D W W W W W W O O O O W W W W W
W W W W W W W W W W W W W W W W W W W O W W W W W W W W W W W W W W W W W W W W
W W W W W W W W W W W W W O O O W W W O W W W W W W W W W W W W W W W W W W W W
W W O O O W W W W W W W W O W O W W W O W W W W W W W W W W W W W W W W W W W W
W W O O O W W W W W W W W O W O O O O O W W W W W W W W W W W W W W W W W W W W
W W O O O I I O O O B O O O W W W W W W W W W W W W W W W W W W W W W W W W W W
W W W W W W W W W W W W W W W W W W W W W W W W W W W W W W W W W W W W W W W W




Enemies: RegisterEnemy TaskSwitcherEnemy VerilogEnemy ||
Items: Coffee RedBullFourPack SnowDay FastFood RedBull ReverseCompiler Virus ||


This is the formatting that must be used!
