40
W W W W W W W W W W W W W W W W W W W W W W W W W W W W W W W W W W W W W W W W
W O W I O O O O O O O O O O O W W I W O O O O O O O O O O W W W W W W W W W O W
W O W I O O O W W W W O O O O O O O W O W W W W W W W W O W O O O O O O O O O W
W O W I W O O O O G W W W O O W W W W O W G O W W W W W O W O W G W W W W W O W
W O W I W O O W W W W W O O W W O O O O W O O W O O O O G W O O O O O O O W O W
W O W G W O O W W W O O O W W O O W W O W O O W O W W W W W W W W W W W O W O W
W O W I W O O W W W O O W W O O W W W O W O O W W W W W W W O O O O O O O W O W
W O W I O O W W O O O W W O O W W I W O W O O W O W W W W W O W W O W W W W O W
W O W W W W W O O O W W O O W W W I W O W O O W O W W W W W O O W O W W W W O W
W O O O O O O O W W W O O W W W O I W O W O O W B O O O W W W O W O G O O W O W
W O W W W W W W W W O O W W W W O O W O W O O W O O W O O O O O I O O O O W O W
W O W O W W O O W W O W W W W W O O W O W O O W W W W W W W W W W W W W W W O W
W O W G W O O O W W O W W G W W O O W O W O O O O O O O O O O O O O O O W W O W
W O W O O O O O W W O O O O W W O O W O W O G W O W O W W O O O O O W O W W O W
W O W O W O O O W W W W W W W W O O W O W O W W O W O W W O O O O O W O W W O W
W O W O W O O O W W W W W W W W O O W O W K W W O W O O O O W B W O W O O O O W
W O W O W W O O W W W W W W W O O O W O W W W W O W O W W O W W W O W O W W O W
W O W O O W W O W W W O O O O O W W W O O O O O O W O O O G W O W I W G W W O W
W O W O I I W O O O O O W W W W W W W W W W W W W W W W W W W O W W W W W W O W
W O W W W W W W W W W O W W W W W W W O O O O O W O O O O O O O W W W I W W O W
W O W O O O O O O O O O O O O O W W W O W W O O O O W O O O W O O O O O W W O W
W O W O W W W W O W W W W O O W W W W O W O O W W W W W O O W W W W W W W W O W
W O W O O O I W O O O O O O W W W W W O W O W W O O O O O O W O O O W O O O O W
W O W O W W W W O W W W W W W W W G W O W O O W W O W O O G W O W O W O W W O W
W O W O W O O O O O W W W W W W W O W O W W I W I O W W O O O O W O O O W W O W
W O W O W O O O O W W W W W W W W O W O W W W W W W W W W W W W W W W W W W O W
W O W O W W W O O W O O O O O O O O W O W O O O O O O O O O O W O O O O O W O W
W O W O O I W O W W O W O W W W W W W O W O W W W O O O W W O O O O O O O W O W
W O W W W W W O W W O W O W W W W W K O W O W W W O W O I I I W O O O W O W O W
W O W W O O O O W W O W O W W W W W O O W O O O O O W O O O O W O O O W O W O W
W O W O O W W W W W O W O W W W W W W W W O W W W O W W W W W W W W W W O O O W
W O W O W W O O O O O W O O O O O O W I O O O O O O W O O O O O O O O W O W O W
W O W O O W O W W W W W W W W W W O W W W W W W W W W O W W W O B O O W O W O W
W O W W O W O O O O O O W O O O O O W O O O W O O O O O O O W O W W W W O W O W
W O W O O W W W W W W O W W O W W O W W O W W O W O W O W O W O W O O W O W O W
W O W O W W W W W W W O W O O W W W W O O O O O W O W O W O W O W O O W O W O W
W O W O O O O O O O O O W O W W O O O O O O O O W G W O W O O O O O O O O W O W
W O W W W W W W W W W W W O W W W W W W W W W W W W W W W W W W W W W W W W O W
W S O D O O O O O O O O O O O O O O O O O O O O O O O O O O O O O O O O O O O W
W W W W W W W W W W W W W W W W W W W W W W W W W W W W W W W W W W W W W W W W


Enemies: KernelEnemy PThreadEnemy ShellEnemy ||
Items: Coffee RedBullFourPack SnowDay FastFood RedBull ReverseCompiler Virus ||


This is the formatting that must be used!
