40
W W W W W W W W W W W W W W W W W W W W W W W W W W W W W W W W W W W W W W W W
W O O O O O O O O O O O O O O O O O W O O O O O O O O O O W W W W W W W W W O W
W O O O O O O O O O O O O O O O O O W O W W W W W W W W O W O O O O O O O O O W
W O O O O O O O O O O O O O O W W W W O W O O W W W W W O W O W G W W W W W O W
W O O O O O O O O O O O O O W W O O O O W O O W O O O O G W O O O O O O O W O W
W O O O O O O O O O O O O W W O O W W O W O O W O W W W W W W W W W W W O W O W
W O O O O O O O O O O O W W O O W W W O W O O W O W W W W W O O O O O O O W O W
W O O O O O O O O O O W W O O O W O W O W O O W O W W W W W O W W O W W W W O W
W O O O O O O O O O W W O O O W W O W O W O O W O W W W W W O O W O W W W W O W
W O O O O O O O O W W O O O W W O O W O W O O W B O O O W W W O W O G O O W O W
W O O O O O O O O W O O O W W O O O W O W O O W O O W O O O O O I O O O O W O W
W O O O O O O O O W O O W W W O O O W O W O O W W W W W W W W W W W W W W W O W
W O O O O O O O O W O W W G W O O O W O W O O O O O O O O O O O O O O O W W O W
W O O O O O O O O W O O O O W O O O W O W O G W O W O O O O O O O O W O W W O W
W O O O O O O O O W W W W W W O O O W O W O W W O W O O O O O O O O W O W W O W
W O O O O O O O O O O O O O O O O O W O W K W W O W O O O O W B W O W O O O O W
W O O O O O O O O O O O O O O O O O W O W W W W O W O O O O W O W O W O W W O W
W O O O O O O O O O O O O O O O O W W O O O O O O W O O O G W O W I W O W W O W
W O O O O O O O O O O O O O O O O W W W W W W W W W W W W W W O W W W O W W O W
W O O O O O O O O O O O O O O O O W W O O O O O O O O O O O O O W W W O W W O W
W O O O O O O O O O O O O O O O O W W O W W O O O O O O O O W O O O O O W W O W
W O O O O O O O O O O O O O O O O W W O W O O W W W W W O O W W W W W W W W O W
W O O O O O O O O O O O O O O O O W W O W O W W O O O O O O O O O O W O O O O W
W O O O O O O O O O O O O O O O O W W O W O O W W O W O O O O O O O W O W W O W
W O O O O O O O O O O O O O O O O W W O W W I W O O W W O O O O O O O O W W O W
W O O O O O O O O O O O O O O O O W W O W W W W W W W W W W W O W W W W W W O W
W O O O O O O O O O O O O O O O O W W O W O O O O O O O O O O O O O O O O W O W
W O W O O O O O O O O O O O O O O W K O W O O O O O W O I I I W O O O W O W O W
W O W O O O O O O O O O O O O O O W O O W O O O O O W O O O O W O O O W O W O W
W O W O O O O O O O O O O O O O O W W W W O O O O O W W W W W W W W W W O O O W
W O W O O O O O O O O O O O O O O O O O O O O O O O W O O O O O O O O W O W O W
W O W O O O O O O O O O O O O O O O O O O O W W W W W O W W W O O O O W O W O W
W O O O O O O O O O O O O O O O O O O O O O W O O O O O O O W O W W W W O W O W
W O W O O O O O O O O O O O O O O O W W O W W O W O W O W O W O W O O W O W O W
W O W O O O O O O O O O O O O W W W W O O O O O W O W O W O W O W O O W O W O W
W O W O O O O O O O O O O O O O O O O O O O O O W O W O W O O O O O O O O W O W
W O W W W W W W W W W W W O W W W W W W W W W W W O W W W W W W W W W W W W O W
W S O O O O O O O O O O O O O O O O O O O O O O O O O O O O O O O O O O O O O W
W W W W W W W W W W W W W W W W W W W W W W W W W W W W W W W W W W W W W W W W

Enemies: KernelEnemy PThreadEnemy ShellEnemy ||
Items: Coffee RedBullFourPack SnowDay FastFood RedBull ReverseCompiler Virus ||


This is the formatting that must be used!
