40
W W W W W W W W W W W W W W W W W W W W W W W W W W W W W W W W W W W W W W W W
W I O O O O W W O O O O O O O O O O O O O O O O O W W O O O W O O O W O O O O W
W O O O O W W O O O O W O W O O O W W W O W W W O W O O W O O O W O O O W O O W
W O O W O W O O O O O W O W O O O O O W O W O O O W O W W O O O O O O O W O O W
W W W W O O O W W O O W O W W W O O O W O W O O O W O O W O O W O O O O W O W W
W O O O O O O O O O O W O O O O O O O O O O O O O W O O O O O W O O W O W O O W
W O O W W W W O O O O O O W W W W W W W W W O O O W O W W W W W O O O O W W O W
W O O W O O O O O O O O O W O O O O O O O W O W O O O O O O O O O W W O W O O W
W O O W O W W W W W W O O W O G W O W G O W O W O O W W W W W W W W W W W W K W
W O O W O W O O O O W O O W O G W O W G O W O W O O W O O W O O O W O O O W W W
W O O W I W O O O O W O I W O G W O W G O W I W O O W O O O O W O O O W O O O W
W O O W W W O O O O W W W W O G W O W G O W W W O O W O W W W W W W W W W W O W
W O O O O O O O O O O O O O O G W O W G O O O O O O W I W O O O O W O O O W O W
W W W W O O W W W O W W W W W W W O W W W W W W W W W W W O O W O O O W O O O W
W O O W W W W O W W W O O O O O O O W O O O O O O O O O W O W W W W W W W W W W
W O O O O O O O O O W O W W W W W W W O W W W W W W W O W O O O O O O O O O O W
W O W W O W O W O O W O W O O O O O O O O O O O O O W O W O W O W W W W O O O W
W O O O O W O O O O W O W O W W W W W W W W W W W O W O W O W O O O O O O O O W
W W W O O W W O O W W O W O O O O O O O O O O O W O W O W O W W W W W W O O O W
W O W W O O W O O O O O W O W O W W W W O W W O W O W O W O O O O O O O O W O W
W O O W W O O O W W W O W O W O W I O O O O W O W O W O W O W W W W W O W W O W
W O O O W W O O O O W O W O W O W O W W W O W O W O W O W O O O O O W O O O O W
W O O W O W W O W O W O W W W O W O O S W O O O W W W O W O W O W O O O W W O W
W O O W O O W W O O W O W O W O W O W W W O W O W O W O W O W O O O W O O W W W
W O O W O O O W W O W O W O W O W O O D O O W O W O W O W O W W O O W O O O O W
W O O O O W O O W W W O W O W O W W W W W W W O W O W O W O O W O O W O W W O W
W O O W O W O O O O W O W O W O O O O O O O O O O O W O W O O W O O W W W O O W
W O O O O W O O W O W O W O W W W W W W W W W W W O W O W O O W W O W O O O O W
W O W W W W O O W O W O W O O O O O O O O O O O O O W O W O O O W O W O W W O W
W O O O O O O O O O W O W W W W W W O W W W W W W W W O W O W O W O W O O W W W
W O W W W W W W O O W O O O O O O O O W O O O O O O O O O O O O O O W O O O O W
W O O O O O O O O O W W W W O W W W W W W W W W W W W W W W W W W O W O W W O W
W O O W W W O O O O O O O O O O O O O O O O O W O O O O O O O O W O W W W O O W
W O O W O W O W O O O W O W W W O W O O O O O W W O O W W W O O W O W O O O O W
W O W W O W O W O O O W O O O O O W W O O O O O W W O O O W O O W O W O W W W W
W O O O O W O W W O W W O W O O O O W W O O O O O W W O O W W W W O W O W O O W
W O W W O O O O W O W O O W O O O O O W O O O O O O W O O O O O O O W O O O G W
W O I W O O O O W O O O O W O O O O O O O O O O O O W O O O O O O O W O I O O W
W W W W W W W W W W W W W W W W W W W W W W W W W W W W W W W W W W W W W W W W

Enemies: BinaryTreeEnemy BigOEnemy DynamicProgrammingEnemy ||
Items: Coffee RedBullFourPack SnowDay FastFood RedBull ReverseCompiler Virus ||


This is the formatting that must be used!
