40
W W W W W W W W W W W W W W W W W W W W W W W W W W W W W W W W W W W W W W W W
W O O O O O O O O O O O O O O O O O O O O O O O O O O O O O O O O O O O O O O W
W O O O O O O O O O O O O O O O O O O O O O O O O O O O O O O O O O O O O O O W
W O O O O O O O O O O O O O O O O O O O O O O O O O O O O O O O O O O O O O O W
W O O O O O O O O O O O O O O O O O O O O O O O O O O O O O O O O O O O O O O W
W O O O O O O O O O O O O O O O O O O O O O O O O O O O O O O O O O O O O O O W
W O O O O O O O O O O O O O O O O O O O O O O O O O O O O O O O O O O O O O O W
W O O O O O O O O O O O O O O O O O O O O O O O O O O O O O O O O O O O O O O W
W O O O O O O O O O O O O O O O O O O O O O O O O O O O O O O O O O O O O O O W
W O O O O O O O O O O O O O O O O O O O O O O O O O O O O O O O O O O O O O O W
W O O O O O O O O O O O O O O O O O O O O O O O O O O O O O O O O O O O O O O W
W O O O O O O O O O O O O O O O O O O O O O O O O O O O O O O O O O O O O O O W
W O O O O O O O O O O O O O O O O O O O O O O O O O O O O O O O O O O O O O O W
W O O O O O O O O O O O O O O O O O O O O O O O O O O O O O O O O O O O O O O W
W O O O O O O O O O O O O O O O O O O O O O O O O O O O O O O O O O O O O O O W
W O O O O O O O O O O O O O O O O O O O O O O O O O O O O O O O O O O O O O O W
W O O O O O O O O O O O O O O O O O O O O O O O O O O O O O O O O O O O O O O W
W O O O O O O O O O O O O O O O O O O O O O O O O O O O O O O O O O O O O O O W
W O O O O O O O O O O O O O O O O O O O O O O O O O O O O O O O O O O O O O O W
W O O O O O O O O O O O O O O O O O S O O O O O O O O O O O O O O O O O O O O W
W O O O O O O O O O O O O O O O O O O O O O O O O O O O O O O O O O O O O O O W
W O O O O O O O O O O O O O O O O O O O O O O O O O O O O O O O O O O O O O O W
W O O O O O O O O O O O O O O O O O O O O O O O O O O O O O O O O O O O O O O W
W O O O O O O O O O O O O O O O O O O O O O O O O O O O O O O O O O O O O O O W
W O O O O O O O O O O O O O O O O O O O O O O O O O O O O O O O O O O O O O O W
W O O O O O O O O O O O O O O O O O O O O O O O O O O O O O O O O O O O O O O W
W O O O O O O O O O O O O O O O O O O O O O O O O O O O O O O O O O O O O O O W
W O O O O O O O O O O O O O O O O O O O O O O O O O O O O O O O O O O O O O O W
W O O O O O O O O O O O O O O O O O O O O O O O O O O O O O O O O O O O O O O W
W O O O O O O O O O O O O O O O O O O O O O O O O O O O O O O O O O O O O O O W
W O O O O O O O O O O O O O O O O O O O O O O O O O O O O O O O O O O O O O O W
W O O O O O O O O O O O O O O O O O O O O O O O O O O O O O O O O O O O O O O W
W O O O O O O O O O O O O O O O O O O O O O O O O O O O O O O O O O O O O O O W
W O O O O O O O O O O O O O O O O O O O O O O O O O O O O O O O O O O O O O O W
W O O O O O O O O O O O O O O O O O O O O O O O O O O O O O O O O O O O O O O W
W O O O O O O O O O O O O O O O O O O O O O O O O O O O O O O O O O O O O O O W
W O O O O O O O O O O O O O O O O O O O O O O O O O O O O O O O O O O O O O O W
W O O O O O O O O O O O O O O O O O O O O O O O O O O O O O O O O O O O O O O W
W W W W W W W W W W W W W W W W W W W W W W W W W W W W W W W W W W W W W W W W

Enemies: BinaryTreeEnemy BigOEnemy DynamicProgrammingEnemy ||
Items: Coffee RedBullFourPack SnowDay FastFood RedBull ReverseCompiler Virus ||


This is the formatting that must be used!
