40
W W W W W W W W W W W W W W W W W W W W W W W W W W W W W W W W W W W W W W W W
W O O O O O O O O O O O O O O O O O O O O O O O O O O O O O O O O O O O O O O W
W O O O O O O W W W O O W W W W O W W W W O W O W W W W O W O O O O W O O O O W
W O O O O O O W O O W O W O O O O W O O O O W O W O O O O W W O O O W O O O O W
W O O O O O O W O O W O W W W O O W W W W O W O W S O O O W O W O O W O O O O W
W O O O O O O W O O W O W K O O O O O O W O W O W O W W O W O O W O W O O O O W
W O O O O O O W O W O O W O O O O O O O W O W O W O O W O W O O O W W O O O O W
W O O O O O O W W O O O W W W W O W W W W O W O W W W W O W O O O O W O O O O W
W O O O O O O O O O O O O O O O O O O O O O O O O O O O O O O O O O O O O O O W
W W W W W W W W W W W W W O W W W W W W W W W W W W O W W W W W W W W W W W W W
W O O O O O O O O O O O O O O O O O O O O O O O O O O O O O O O O O O O O O O W
W O O W W W O O O O O O O O O O O O O O O O O O O O O O O O O O O O W W W O O W
W O O O W O O O O W O O O O O O O O O W W O O O O O O O O O O O W O O W O O O W
W O O O W O O O O W O O O O O O O O W W W W O O O O O O O O O O W O O W O O O W
W O O O W O O O O W O O O O O O O W W W W W W O O O O O O O O O W O O W O O O W
W O O O W O O O O W O O O O O O W W W W W W W W O O O O O O O O W O O W O O O W
W O O W W W O O W W O O O O O W W W W W W W W W W O O O O O O W W O W W W O O W
W O O O O O O O W O O O O O W W W W W W W W W W W W O O O O O W O O O O O O O W
W O O O W O O O W O O O O W W W W W W W W W W W W W W O O O O W O O O W O O O W
W O O O W O O O W O O O O O O O O O O W W O O O O O O O O O O W O O O W O O O W
W O O O W W W W W O O O O O O O O O O W W O O O O O O O O O O W W W W W O O O W
W O O O W O O O O O O O O O O O O O O W W O O O O O O O O O O O O O O W O O O W
W O O O W O O O O O O W O O O O O O O W W O O O O O O O W O O O O O O W O O O W
W O O O W O O O O O W W O O O O O O O W W O O O O O O W W O O O O O O W O O O W
W O O O W O O O O W O W O O O O O O O W W O O O O O W O W O O O O O O W O O O W
W O O O W O O O W W W W W O O O O O O O O O O O O W W W W W O O O O O W O O O W
W O O O W O O O O O O W O O O O O O O O O O O O O O O O W O O O O O O W O O O W
W O O O W I O O O O O W O O O W W W W W W W W W W O O O W O O O O O I W O O O W
W O O O O O O O O O O O O O O O O O O O O O O O O O O O O O O O O O O O O O O W
W O O O O O W W W W W W W W W W O O O O O O O O W W W W W W W W W W O O O O O W
W O O O O O W O O O O O O O O W O W W W W W W O W O O O O O O O O W O O O O O W
W O O O O O W O O W O O W O O W O O O O O O O O W O O W O O W O O W O O O O O W
W O O O O O W W O W O O W W W W O O O O O O O O W W W W O O W O W W O O O O O W
W O O O O O W O O W O O W O O O O O O W W O O O O O O W O O W O O W O O O O O W
W O O O O O W O W W O O W O O O O O W W W W O O O O O W O O W W O W O O O O O W
W O O O O O W O O O O O W O O O O W W O O W W O O O O W O O O O O W O O O O O W
W O O O O O W O W W W W W O O O W W I D O I W W O O O W W W W W O W O O O O O W
W O O O O I W O O W O O O O O W W O O W W O O W W O O O O O W O O W I O O O O W
W W W W W W W O O O O W O O O O O O O W W O O O O O O O W O O O O W W W W W W W
W W W W W W W W W W W W W W W W W W W W W W W W W W W W W W W W W W W W W W W W

Enemies: CodeSmellEnemy DecoratorEnemy RefactoringEnemy ||
Items: Coffee RedBullFourPack SnowDay FastFood RedBull ReverseCompiler Virus ||


This is the formatting that must be used!

For this level design "patterns" the whole maze is a pattern, after user gets that the task becomes alot easier.
